11111111111
1C0111C0E11
110M1M0M0C1
1M0P00C1011
11111111111