1111111111111111111111111
1000000000000000000000001
100010010C0M111C00M0C0001
11P0000000000000000000001
1100000C0MC0C000M01000001
1100000M100101111C0CM0001
1000C0001MC10CM01M00E0001
1000M0001111011110C0M0001
1000C00000M1C100M010C0001
1000000M0C01M1111C0M10001
1100000000000000000000001
1100000000000000000000001
1111111111111111111111111
