1110111
1PC01E1
1000111
1111111