1110111
1PC0ME1
1000MM1
1111111